solid | твердый
somebody | кто-то
rely | полагаться
just | просто
mapping | отображение
just | просто
out of | снаружи
out of date | устаревший
massive | большой
a lot | много
in | в
comprehend | постигать
grasp | понять
if | если
inefficient | неэффективный
there | здесь
was | был
performance | производительность
suboptimal | неоптимальный
spill over | перетекать
spill the beans | раскрыть секрет
spill | проливать
oil spill | разлив нефти
oil | масло
you | вы
fetch | получать
excessively | чрезмерно
conflict | конфликт
might | может
from here | отсюда
from | от
talk | говорить